1942.zip	"1942"	"Shooter"
1943.zip	"1943"	"Shooter"
1943kai.zip	"1943 Kai"	"Shooter"
720.zip	"720"	"Sports"
aburner.zip	"After Burner"	"Shooter"
aburner2.zip	"After Burner 2"	"Shooter"
acrobatm.zip	"Acrobat Mission"	"Shooter"
actfancr.zip	"Act-Fancer"	"Action"
aerofgt.zip	"Aero Fighters"	"Shooter"
agallet.zip	"Air Gallet"	"Shooter"
airbustr.zip	"Air Buster"	"Shooter"
airduel.zip	"Air Duel"	"Shooter"
aliens.zip	"Aliens"	"Action"
arabianm.zip	"Arabian Magic"	"Action"
arbalest.zip	"Arbalester"	"Shooter"
arcadecl.zip	"Arcade Classics"	"Shooter"
arkanoid.zip	"Arkanoid"	"Puzzle"
arknoid2.zip	"Arkanoid 2"	"Puzzle"
arkretrn.zip	"Arkanoid Returns"	"Puzzle"
ashura.zip	"Ashura Blaster"	"Shooter"
assault.zip	"Assault"	"Shooter"
astdelux.zip	"Asteroids Deluxe"	"Shooter"
asteroid.zip	"Asteroids"	"Shooter"
baddudes.zip	"Bad Dudes"	"Action"
badlands.zip	"Badlands"	"Sports"
bangball.zip	"Bang Ball"	"Puzzle"
batman.zip	"Batman"	"Action"
batrider.zip	"Armored Police Batrider"	"Shooter"
batsugun.zip	"Batsugun"	"Shooter"
battleg.zip	"Battle Garega"	"Shooter"
batugnsp.zip	"Batsugun Special Version"	"Shooter"
bayroute.zip	"Bay Route"	"Shooter"
bbakraid.zip	"Battle Bakraid"	"Shooter"
bbmanw.zip	"Bomber Man World"	"Puzzle"
berlwall.zip	"Berlin Wall"	"Puzzle"
bermudat.zip	"Bermuda Triangle"	"Shooter"
bigrun.zip	"Big Run"	"Sports"
bioship.zip	"Bio-Ship Paladin"	"Shooter"
blandia.zip	"Blandia"	"Beat'em Up"
blkheart.zip	"Black Heart"	"Shooter"
blmbycar.zip	"Blomby Car"	"Sports"
bloodbro.zip	"Blood Brothers"	"Action"
bloodstm.zip	"Blood Storm"	"Beat'em Up"
blstroid.zip	"Blasteroids"	"Shooter"
blswhstl.zip	"Bells & Whistles"	"Shooter"
bluehawk.zip	"Bluehawk"	"Shooter"
blzntrnd.zip	"Blazing Tornado"	"Beat'em Up"
bmaster.zip	"Blade Master"	"Action"
bottom9.zip	"Bottom of the Ninth"	"Sports"
bouldash.zip	"Boulder Dash"	"Puzzle"
bshark.zip	"Battle Shark"	"Shooter"
bssoccer.zip	"Back Street Soccer"	"Sports"
bubblem.zip	"Bubble Memories"	"Puzzle"
bublbob2.zip	"Bubble Bobble 2"	"Puzzle"
bublbobl.zip	"Bubble Bobble"	"Puzzle"
bucky.zip	"Bucky O'Hare"	"Action"
burglarx.zip	"Burglar X"	"Action"
burnforc.zip	"Burning Force"	"Shooter"
calibr50.zip	"Caliber 50"	"Shooter"
captaven.zip	"Captain America"	"Action"
cbuster.zip	"Crude Busters"	"Action"
chimerab.zip	"Chimera Beast"	"Shooter"
chinagat.zip	"China Gate"	"Action"
cischeat.zip	"Cisco Heat"	"Sports"
cninja.zip	"Caveman Ninja"	"Jump'n Run"
contra.zip	"Contra"	"Action"
crshrace.zip	"Crash Race"	"Sports"
cscluba.zip	"Capcom Sports Club"	"Sports"
ctribe.zip	"Combatribes"	"Action"
cybattlr.zip	"Cybattler"	"Shooter"
daraku.zip	"Daruki Tenshi"	"Beat'em Up"
darius.zip	"Darius"	"Shooter"
darius2.zip	"Darius 2"	"Shooter"
dariusg.zip	"Darius Gaiden"	"Shooter"
darkseal.zip	"Dark Seal"	"Action"
dblaxle.zip	"Double Axle"	"Sports"
dbreed.zip	"Dragon Breed"	"Shooter"
ddonpach.zip	"Dodonpachi"	"Shooter"
ddragon.zip	"Double Dragon"	"Action"
ddragon2.zip	"Double Dragon 2"	"Action"
ddragon3.zip	"Double Dragon 3"	"Action"
deadconx.zip	"Dead Connection"	"Action"
devstors.zip	"Devastators"	"Shooter"
dinorex.zip	"Dino Rex"	"Beat'em Up"
dkong.zip	"Donkey Kong"	"Jump'n Run"
dkong3.zip	"Donkey Kong 3"	"Jump'n Run"
dkongjr.zip	"Donkey Kong Junior"	"Jump'n Run"
dogyuun.zip	"Dogyuun"	"Shooter"
donpachi.zip	"DonPachi"	"Shooter"
downtown.zip	"Downtown"	"Action"
drifto94.zip	"Drift Out 94"	"Sports"
driftout.zip	"Drift Out"	"Sports"
dsaber.zip	"Dragon Saber"	"Shooter"
dsoccr94.zip	"Dream Soccer 94"	"Sports"
dungeonm.zip	"Dungeon Magic"	"Action"
dw.zip	"Dynasty Wars"	"Action"
dynduke.zip	"Dynamite Duke"	"Shooter"
edf.zip	"Earth Defense"	"Shooter"
eightfrc.zip	"Eight Forces"	"Shooter"
elvactr.zip	"Elevator Action Returns"	"Action"
esprade.zip	"Esp Ra.De."	"Shooter"
firebarr.zip	"Fire Barrel"	"Shooter"
ga2.zip		"Golden Axe 2"	"Action"
goldnaxe.zip	"Golden Axe"	"Action"
gaxeduel.zip	"Golden Axe Duel"	"Action"
gaiden.zip	"Ninja Gaiden"	"Action"
galaga88.zip	"Galaga 88"	"Shooter"
gallop.zip	"Gallop - Armored Police Unit"	"Shooter"
gangwars.zip	"Gang Wars"	"Action"
gbusters.zip	"Gang Busters"	"Shooter"
gcpinbal.zip	"Grand Cross Pinball"	"Puzzle"
gekirido.zip	"Gekirindan"	"Shooter"
gigandes.zip	"Gigandes"	"Shooter"
gijoe.zip	"GI Joe"	"Shooter"
gradius3.zip	"Gradius 3"	"Shooter"
grdnstrm.zip	"Guardian Storm"	"Shooter"
growl.zip	"Growl"	"Action"
gseeker.zip	"Grid Seeker - Project Stormhammer"	"Shooter"
gtmr.zip	"Great 1000 Miles Rally"	"Sports"
gtmr2.zip	"Great 1000 Miles Rally 2"	"Sports"
gunbird.zip	"Gun Bird"	"Shooter"
gunbird2.zip	"Gun Bird 2"	"Shooter"
gundhara.zip	"Gundhara"	"Shooter"
gunfront.zip	"Gun & Frontier"	"Shooter"
gunlock.zip	"Gunlock"	"Shooter"
hachoo.zip	"Hachoo!"	"Action"
hangonjr.zip	"Hang-On! Junior"	"Sports"
hardyard.zip	"Hard Yardage"	"Sports"
hharry.zip	"Hammerin Harry"	"Jump'n Run"
hippodrm.zip	"Hippodrome"	"Beat'em Up"
hitice.zip	"Hit the Ice"	"Sports"
hook.zip	"Hook"	"Action"
hotchase.zip	"Hot Chase"	"Sports"
hotdogst.zip	"Hotdog Storm"	"Shooter"
hotpinbl.zip	"Hot Pinball"	"Puzzle"
ikari3.zip	"Ikari 3 - The Rescue"	"Action"
jdredd.zip	"Judge Dredd"	"Action"
kageki.zip	"Kageki"	"Beat'em Up"
kaiserkn.zip	"Kaiser Knuckle"	"Beat'em Up"
karatblz.zip	"Karate Blazers"	"Action"
karatour.zip	"Karate Tournament"	"Action"
karianx.zip	"Karian Cross"	"Puzzle"
kbash.zip	"Knuckle Bash"	"Action"
knckhead.zip	"Knuckle Heads"	"Beat'em Up"
kov.zip	"Knights of Valour"	"Action"
kovplus.zip	"Knights of Valour Plus"	"Action"
ktiger2.zip	"Kyukyoku Tiger 2"	"Shooter"
landmakr.zip	"Landmaker"	"Puzzle"
lethalth.zip	"Lethal Thunder"	"Puzzle"
lgtnfght.zip	"Lightning Fighter"	"Puzzle"
loderndf.zip	"Lode Runner"	"Puzzle"
logicpr2.zip	"Logic Pro 2"	"Puzzle"
logicpro.zip	"Logic Pro"	"Puzzle"
macross.zip	"Macross"	"Shooter"
macross2.zip	"Macross 2"	"Shooter"
macrossp.zip	"Macross Plus"	"Shooter"
madmotor.zip	"Mad Motor"	"Sports"
magicbub.zip	"Magic Bubble"	"Sports"
mahoudai.zip	"Mahou Daisakusen"	"Shooter"
marble.zip	"Marble Madness"	"Puzzle"
mario.zip	"Mario Brothers"	"Jump'n Run"
masterw.zip	"Master of Weapon"	"Shooter"
mazinger.zip	"Mazinger Z"	"Shooter"
metafox.zip	"Meta Fox"	"Shooter"
metalb.zip	"Metal Black"	"Shooter"
metmqstr.zip	"Metamoquester"	"Beat'em Up"
mia.zip	"Missing in Action"	"Action"
mk.zip	"Mortal Kombat"	"Beat'em Up"
mk2.zip	"Mortal Kombat 2"	"Beat'em Up"
mk3.zip	"Mortal Kombat 3"	"Beat'em Up"
moo.zip	"Wild West C.O.W."	"Action"
msgundam.zip	"Mobile Suid Gundam"	"Beat'em Up"
mysticri.zip	"Mystic Riders"	"Shooter"
nbahangt.zip	"NBA Hangtime"	"Sports"
nbajam.zip	"NBA Jam"	"Sports"
nebulray.zip	"Nebulas Ray"	"Shooter"
ninclown.zip	"Ninja Clowns"	"Action"
ninjaw.zip	"Ninja Warriors"	"Action"
openice.zip	"2 on 2 Open Ice Challenge"	"Sports"
orlegend.zip	"Oriental Legend"	"Action"
p47.zip	"P47 - The Phantom Fighter"	"Shooter"
pacmania.zip	"Pacmania"	"Puzzle"
pacplus.zip	"Pac Plus"	"Puzzle"
pang.zip	"Pang"	"Puzzle"
paperboy.zip	"Paperboy"	"Action"
parodius.zip	"Parodius"	"Shooter"
pbobble.zip	"Puzzle Bobble"	"Puzzle"
pbobble2.zip	"Puzzle Bobble 2"	"Puzzle"
pbobble3.zip	"Puzzle Bobble 3"	"Puzzle"
pbobble4.zip	"Puzzle Bobble 4"	"Puzzle"
pitfall2.zip	"Pitfall 2"	"Jump'n Run"
pollux.zip	"Pollux"	"Shooter"
poundfor.zip	"Pound for Pound"	"Sports"
pow.zip	"Prisoners of War"	"Action"
powerins.zip	"Power Instinct"	"Beat'em Up"
prehisle.zip	"Prehistoric Isle in 1930"	"Shooter"
psoldier.zip	"Perfect Soldiers"	"Beat'em Up"
punkshot.zip	"Punk Shot"	"Beat'em Up"
pwrgoal.zip	"Power Goal"	"Beat'em Up"
pzlbowl.zip	"Puzzle de Bowling"	"Puzzle"
qcrayon2.zip	"Shinchan"	"Puzzle"
rambo3.zip	"Rambo 3"	"Shooter"
rampage.zip	"Rampage"	"Action"
reikaids.zip	"Reikai Dousi"	"Beat'em Up"
renegade.zip	"Renegade"	"Action"
rezon.zip	"Rezon"	"Shooter"
ridingf.zip	"Riding Fight"	"Action"
ringdest.zip	"Ring of Destruction"	"Beat'em Up"
riotcity.zip	"Riot City"	"Action"
rmpgwt.zip	"Rampage World Tour"	"Action"
rollerg.zip	"Rollergames"	"Action"
rshark.zip	"R-Shark"	"Shooter"
rtype.zip	"R-Type"	"Shooter"
rtype2.zip	"R-Type 2"	"Shooter"
rtypeleo.zip	"R-Type Leo"	"Shooter"
ryujin.zip	"Ryu Jin"	"Shooter"
s1945ii.zip	"Strikers 1945 II"	"Shooter"
sailormn.zip	"Pretty Soldier Sailor Moon"	"Action"
salamand.zip	"Salamander"	"Shooter"
sandscrp.zip	"Sand Scorpion"	"Shooter"
sbomberb.zip	"Space Bomber"	"Shooter"
scfinals.zip	"Super Cup Finals"	"Sports"
sci.zip	"Special Criminal Investigation"	"Sports"
scontra.zip	"Super Contra"	"Action"
sftm.zip	"Street Fighter - The Movie"	"Beat'em Up"
shadfrce.zip	"Shadow Force"	"Action"
shippumd.zip	"Shippu Mahou Daisakusen"	"Shooter"
silentd.zip	"Silent Dragon"	"Action"
silkroad.zip	"Legend of Silkroad"	"Action"
simpsons.zip	"Simpsons"	"Action"
skyalert.zip	"Sky Alert"	"Shooter"
skysoldr.zip	"Sky Soldiers"	"Shooter"
slapshot.zip	"Slap Shot"	"Sports"
slyspy.zip	"Sly Spy"	"Action"
sngkace.zip	"Sengoku Ace"	"Shooter"
soldivid.zip	"Sol Divide"	"Shooter"
spacedx.zip	"Space Invaders DX"	"Shooter"
spang.zip	"Super Pang"	"Puzzle"
spcinv95.zip	"Space Invaders 95"	"Shooter"
spf2t.zip	"Super Puzzle Fighter 2 Turbo"	"Puzzle"
spinlbrk.zip	"Spinal Break"	"Action"
ssi.zip	"Super Space Invaders 91"	"Shooter"
stagger1.zip	"Stagger 1"	"Shooter"
stdragon.zip	"Saint Dragon"	"Shooter"
stlforce.zip	"Steel Force"	"Action"
stmblade.zip	"Storm Blade"	"Shooter"
strahl.zip	"Koutetsu Yousai Strahl"	"Shooter"
streetsm.zip	"Street Smart"	"Beat'em Up"
superchs.zip	"Super Chase - Criminal Termination"	"Sports"
suprslam.zip	"Super Slams"	"Sports"
survarts.zip	"Survival Arts"	"Beat'em Up"
sxyreact.zip	"Sexy Reaction"	"Puzzle"
tdragon2.zip	"Thunder Dragon 2"	"Shooter"
thunderx.zip	"Thunder Cross"	"Shooter"
tigeroad.zip	"Tiger Road"	"Action"
timekill.zip	"Time Killers"	"Beat'em Up"
tknight.zip	"Tecmo Knight"	"Action"
tmnt.zip	"Teenage Mutant Ninja Turtles"	"Action"
tmnt2.zip	"Teenage Mutant Ninja Turtles 2"	"Action"
totcarn.zip	"Total Carnage"	"Action"
truxton2.zip	"Truxton 2"	"Shooter"
turbofrc.zip	"Turbo Force"	"Shooter"
twincobr.zip	"Twin Cobra"	"Shooter"
twineagl.zip	"Twin Eagle"	"Shooter"
umk3.zip	"Ultimate Mortal Kombat 3"	"Beat'em Up"
valkyrie.zip	"Valkyrie"	"Action"
vendetta.zip	"Vendetta"	"Action"
vfive.zip	"V-Five"	"Shooter"
vulcan.zip	"Vulcan Venture"	"Shooter"
warriorb.zip	"Warrior Blade"	"Shooter"
wcbowl.zip	"World Class Bowling"	"Sports"
wrofaero.zip	"War of Aero"	"Shooter"
wwfmania.zip	"WWF - Wrestlemania"	"Sports"
xexex.zip	"Xexex"	"Sports"
xmen.zip	"X-Men"	"Action"
aquajack.zip	"Aquajack"	"Action"
asterix.zip	"Asterix"	"Action"
chasehq.zip	"Chase HQ"	"Sports"
gunforc2.zip	"Gunforce 2"	"Action"
gunforce.zip	"Gunforce"	"Action"
indytemp.zip	"Indiana Jones and the Temple of Doom"	"Action"
inthunt.zip	"In the Hunt"	"Shooter"
missw96.zip	"Miss World Nude 96"	"Puzzle"
nbbatman.zip	"Ninja Baseball Batman"	"Puzzle"
nemesis.zip	"Nemesis"	"Shooter"
punchout.zip	"Punchout"	"Sports"
raiden.zip	"Raiden"	"Shooter"
thndrx2.zip	"Thunder Cross 2"	"Shooter"
uccops.zip	"Undercover Cops"	"Action"
hyperpcb.zip	"Hyper Pacman"		"Puzzle"
hyprdelj.zip	"Hyper Duel"		"Shooter"
